┌───┬─────────┬─────────────┬───────────┬─────────────┬─────┬─────────┬───┐ 
├─╴ │ ╷ ┌───┐ │ ┌─╴ ┌─┬───╴ │ ╶───┐ ┌─╴ ├─╴ ┌───┬───┐ │ ╷ ╶─┘ ┌───┐ ╷ │ ╷X│ 
│ ╶─┤ ├─┘ ╷ │ │ │ ┌─┘ ╵ ┌───┴─────┤ │ ╶─┘ ┌─┘ ╷ │ ╷ └─┘ ├─┬───┤ ╷ ╵ │ │ └─┤ 
├─┐ │ ╵ ┌─┤ │ ├─┘ │ ╶─┬─┴─┐ ┌───┐ │ └─────┤ ╶─┤ │ └─┬───┘ │ ╷ ╵ ├───┤ └─╴ │ 
│ ╵ │ ╶─┘ │ │ │ ┌─┴─┐ ╵ ╷ ╵ │ ╶─┤ └───┬─╴ └─┐ │ └─┐ │ ╷ ╷ │ ├───┤ ╷ └─┬─╴ │ 
│ ┌─┴─┬───┘ │ ╵ │ ╷ └───┼───┘ ╷ ├───╴ │ ╶───┘ └─┐ ╵ │ │ └─┤ │ ╷ └─┤ ╶─┘ ╶─┤ 
│ │ ╷ ╵ ┌───┴─┬─┘ ├─╴ ┌─┘ ┌───┤ │ ┌───┴─────┬─┐ └───┤ ├─╴ │ ╵ ├─┐ └─────┐ │ 
│ ╵ ├─┬─┴─╴ ╷ ╵ ┌─┤ ╶─┤ ┌─┘ ╶─┤ │ └───┐ ╶─┐ │ └───┐ ├─┘ ╷ ├───┘ ├─────┐ └─┤ 
├───┘ │ ╷ ╶─┴─┬─┘ └─┐ │ └───╴ │ └───┐ ├─╴ │ │ ╷ ╶─┘ ╵ ┌─┤ ├───┐ ╵ ╷ ╶─┼─╴ │ 
│ ┌─╴ │ ├─┬─╴ │ ┌─╴ │ └─┬───┐ ├─┐ ╶─┘ │ ┌─┘ └─┴─────┬─┤ ╵ │ ╷ └─┐ └─┐ │ ╶─┤ 
│ └─┐ │ ╵ │ ┌─┘ └───┼─╴ │ ╷ │ ╵ ├───┬─┘ └─┬─────┬─┐ │ ╵ ┌─┘ ├─┐ └───┘ ├─┐ │ 
├─╴ │ └─┐ │ └─────┐ ╵ ┌─┘ │ └─┐ ├─╴ │ ╶─┐ └─┐ ╷ ╵ │ └─┐ └─┐ │ └───┬─╴ ╵ │ │ 
│ ╶─┴─┐ │ └─┬───┐ │ ╶─┴─╴ ├───┘ │ ╶─┘ ┌─┴─╴ │ └───┴─╴ ├─╴ ╵ │ ╶─┐ ╵ ┌───┤ │ 
├───╴ ├─┴─╴ ╵ ╷ │ └─┬───┬─┘ ┌───┘ ┌───┘ ┌───┘ ┌───┐ ╶─┼─────┴─┬─┴───┤ ╷ ╵ │ 
│ ┌───┘ ┌───┬─┴─┼─╴ │ ╷ ╵ ┌─┴─┐ ╶─┤ ╶───┤ ┌───┘ ╷ └─┐ ╵ ┌───╴ │ ┌─╴ ╵ ├─╴ │ 
│ │ ┌───┴─╴ │ ╷ ╵ ╷ │ └───┘ ╷ ├─╴ ├───┐ └─┘ ╶─┬─┴─┐ ├───┤ ┌───┘ └─────┤ ╶─┤ 
│ ╵ │ ╷ ╶─┐ │ └─┬─┘ └─┬─┬───┤ └───┘ ╷ └─────┐ └─╴ │ └─┐ ╵ └─────┬───┐ ├─┐ │ 
│ ┌─┤ └─┐ │ └─┐ └─┬─╴ ╵ │ ╷ ├───────┴─┬───┐ └─┐ ┌─┴─┐ └───┬───╴ │ ╷ │ │ │ │ 
│ │ └─┐ │ ├───┼─╴ ├─────┤ │ │ ┌─┐ ╶───┘ ╷ └─┐ └─┘ ╷ │ ╶─┐ └───┐ │ │ ╵ │ │ │ 
│ │ ╶─┘ │ ╵ ╷ │ ╶─┘ ┌─┐ ╵ │ ╵ │ └─┬─┬───┤ ╶─┼─────┤ └───┴─┐ ╷ │ │ └─┬─┤ ╵ │ 
│ └─────┼───┘ └─────┤ └─┬─┴─┬─┘ ╷ ╵ │ ╷ └─╴ │ ╷ ╷ ├─────╴ ├─┘ │ └─┐ │ │ ┌─┤ 
├─────╴ ╵ ┌───────╴ ╵ ╷ ╵ ╷ ╵ ┌─┴─╴ │ └─────┘ │ └─┘ ╶─────┘ ┌─┴─╴ ╵ │ ╵ ╵ │ 
└─────────┴───────────┴───┴───┴─────┴─────────┴─────────────┴───────┴─────┘ 