+---+---+----------------+----+----------------+---+---+---+------------------+
|   |   |                |    |                |   |   |   |                  |
|   |   |                |    |       +----+   |   |   |   |                  |
|   |   |                |    |       |    |   |   |   |   |   +------+       |
|   |   |                |    |       |    |   |   |   |   |   |      |       |
|   |   |                |    |       |    |   |   |   |   |   |      |       |
|   |   |    +----+      |    |       |    |   |   |   |   |   |      |       |
|   |   |    |    |      |    |       |    |   |   |   |   |   |      |       |
|   |   |    |    |      |    |       |    |   |   |   |   |   |      |       |
|   |   |    |    |      |    |       |    |   |   |   |   |   |      |       |
|   |   |    |    |      |    |       |    |   |   |   |   |   |      |       |
|   |   |    |    |      |    |       |    |   |   |   |   |   |      |       |
|   |   |    |    |      |    |       |    |   |   |   |   |   |      |       |
|   |   |    |    |      |    |       |    |   |   |   |   |   |      |       |
|   |   |    |    |      |    |       |    |   |   |   |   |   |      |       |
|   |   |    |    |      |    |       |    |   |   |   |   |   |      |       |
|   |   |    |    |      |    |       |    |   |   |   |   |   |      |       |
|   |   |    |    |      |    |       |    |   +---+   +---+   |      |       |
|   +---+    |    |      |    |       |    |                   |      |       |
|            |    |      +----+       |    |                   |      |       |
|            |    |                   |    |      +---+        |      |       |
|            |    |                   |    |      |   |        |      |       |
|            |    |                   |    |      |   |        |      |       |
|            |    |                   |    |      |   |        |      |       |
|            |    |                   |    |      |   |        |      |       |
|            |    |                   |    |      |   |        |      |       |
|            |    |                   |    |      |   |        |      |       |
|            |    |                   |    |      |   |        |      |       |
|            |    |                   |    |      |   |        |      |       |
|            |    |                   |    |      |   |        |      |      X|
+------------+----+-------------------+----+------+---+--------+------+-------+