+---+---+---+---+---+---+---+---+---+---+---+---+---+---+
|               |           |       |   |   |       |   |
+   +---+---+   +---+---+   +   +   +   +   +---+   +   +
|   |       |   |           |   |   |                   |
+   +   +---+   +---+---+---+   +   +   +---+---+---+   +
|       |               |       |   |   |       |       |
+---+   +   +---+---+   +   +---+   +   +---+   +---+   +
|   |   |   |       |   |   |       |   |   |   |       |
+   +   +---+   +   +   +---+   +---+   +   +---+---+   +
|   |   |       |   |   |       |       |           |   |
+   +-  +---+   +   +   +---+   +   +---+   +---+   +   +
|   |       |   |   |   |       |   |       |       |   |
+---+   +   +---+   +   +---+   +   +   +---+---+   +   +
|       |           |       |       |   |           |   |
+   +---+---+---+   +---+   +---+   +   +---+---+   +   +
|               |       |           |   |       |   |   |
+---+---+---+   +---+   +---+---+   +   +   +   +   +   +
|               |       |       |   |   |   |   |   |   |
+   +---+---+   +---+   +---+   +---+   +   +   +   +   +
|   |           |       |       |       |   |   |   |   |
+   +---+---+   +---+   +---+   +---+   +   +   +   +   +
|           |           |               |   |   |   | X |
+---+---+---+---+---+---+---+---+---+---+---+---+---+---+