+---+---+---+---+---+
|   |       |       |
+  -+---+   +   +   +
|       |       |   |
+   +   +---+   +   +
|   |       |       |
+   +   +  -+   +-  +
|   |   |       | X |
+---+---+---+---+---+